NO ./png_files/castle.png
SO ./png_files/castle1.png
EA ./png_files/castle2.png
WE ./png_files/castle3.png

C 211,211,211
F 128,128,128




111111111111111111111111111111111111111111
1111100000000000000000000000000000111111111111111111111111111111111111111111111111111111111111111111
111000000000111111111100000110000001110111011101110111011101110111111111
11111100000111111   11000001111100000000000000000000000000000000000000001111111111111111111
11100000000011111    1000001   1100001000100010001000100010001000111111111111111111111111111111111111111111111111111111111111111111111111111111111
111111111100000111111100000111110000111111001111110011111100111111001111110011111100111111001111111111
         1010000000000000000000000000001111111000001111111000001111111000001111111000001111111000001111111111111111111111111111111
1111111111111111011111111110000000000000000000000000000000000000000001000000000001000000000001000000000001000000000001000000000001
1001           101       100000000000000000000000000000000000000000001000000000001000000000001000000000001000000000001000000000001
1001           101       100000000000000000000000000000000000000000001000000000001000000000001000000000001000000000001000000000001
1001           101       100000000000000000000000000000000000000000001000000000001000000000001000000000001000000000001000000000001
1001           101       100000000000000000000000000000000000000000001000000000001000000000001000000000001000000000001000000000001
1001           101       100000000000000000000000000000000000000000001000000000001000000000001000000000001000000000001000000000001
1001           101       100000000000000000000000000000000000000000001000000000001000000000001000000000001000000000001000000000001
1001           101       100000000000000000000000000000000000000000001000000000001000000000001000000000001000000000001000000000001
1001           101       100000000000000000000000000000000000000000001000000000001000000000001000000000001000000000001000000000001
1011111111111111011111111110000000000000000000000000000000000000000001000000000001000000000001000000000001000000000001000000000001
100000011      101        10000000000000000000000000000000000000000001000000000001000000000001000000000001000000000001000000000001
1000000011111111011111111110000000000000000000000000000000000000000001000000000001000000000001000000000001000000000001000000111111
1000000000000000000000000000000000000000000000000000000000000000000010000000000010000000000010000000000010000000000010000001
1000000000000000000000000000000000000000000000000000000000000000000010000000000010000000000010000000000010000000000010000001
1000000000000000000000000000000000000000000000000000000000000000000010000000000010000000000010000000000010000000000010000001
1000000000000000000000000000000000000000000000000000000000000000000010000000000010000000000010000000000010000000000010000001
1000000000000000000000000000000000000001111111111111111111111111111111100111111111111111111111111111111111111000000001000000111
1000000000000000000000000000000000000001                              1001                                 10000000001000000000111
1000000000000000000000000000000000000001                              1001                                 10000000001000000000001
1000000000001110000000000000000000000001                              1001                                 10000000001000000000001
1000000000000010000000000000000000000001                              1001                                 10000000001000000000001
1000000000001000000000000000000000000101                              1001                                 10000000001000000000001
1000000000001110000000000000000000001001                              1001                                 10000000001000000000001
1000000000000000000000000000000000000001                              1001                                 10000000001000000000001
1000000000000000000000000000000000000001                              1001                                 10000000001000000000001
1000000000000000000000000000000000000001                              1001                                 10000000001000000000001
1000000000000000000000000000000000000001                              1001                                 10000000001000000000001
100000000000000000000000000000000000S001                              1001                                 10000000001000000000001
1000000000000000000000000000000000000000111111111111111111111111111111000011111111111111111111111111111111100000000001000000000001
1000000000000000000000000000000000000000000000000000000000000000000000011000000000000000000000000000000000000000000001000000000001
1000000000000000000000000000000000000000111111111111111111111111111111000011111111111111111111111111111111100000000001000000000001
1000000000000000000000000000000000000001                              1001                                 10000000001000000000001
1000000000000000000000000000000000000001                              1001                                 10000000001000000000001
1000000000000000000000000000000000000001                              1001                                 10000000001000000000001
1000000000000000000000000000000000000001                              1001                                 10000000001000000000001
1000000000000000000000000000000000000001                              1001                                 10000000001000000000001
1000000000000000000000000000000000000001                              1001                                 10000000001000000000001
1000000000000000000000000000000000000001                              1001                                 10000000001000000000001
1000000000000000000000000000000000000001                              1001                                 10000000001000000000001
1000000000000000000000000000000000000001                              1001                                 10000000001000000000001
1000000000000000000000000000000000000001                              1001                                 10000000001000000000001
1000000000000000000000000000000000000011111111111111111111111111111111100111111111111111111111111111111111110000000001000000000001
1000000000000000000000000000000000000000000000000000000000000000000001000000000001000000000001000000000001000000000001000000000001
1000000000000000000000000000000000000000000000000000000000000000000001000000000001000000000001000000000001000000000001000000000001
1000000000000000000000000000000000000000000000000000000000000000000001000000000001000000000001000000000001000000000001000000000001
1000000000000000000000000000000000000000000000000000000000000000000001000000000001000000000001000000000001000000000001000000000001
1000000000000000000000000000000000000000000000000000000000000000000001000000000001000000000001000000000001000000000001000000000001
1000000000000000000000000000000000000000000000000000000000000000000001000000000001000000000001000000000001000000000001000000000001
1000000000000000000000000000000000000000000000000000000000000000000001000000000001000000000001000000000001000000000001000000000001
1000000000000000000000000000000000000000000000000000000000000000000001000000000001000000000001000000000001000000000001000000000001
1000000000000000000000000000000000000000000000000000000000000000000001000000000001000000000001000000000001000000000001000000000001
1000000000000000000000000000000000000000000000000000000000000000000001000000000001000000000001000000000001000000000001000000000001
1000000000000000000000000000000000000000000000000000000000000000000001000000000001000000000001000000000001000000000001000000000001
1000000000000000000000000000000000000000000000000000000000000000000001000000000001000000000001000000000001000000000001000000000001
1000000000000000000000000000000000000000000000000000000000000000000001000000000001000000000001000000000001000000000001000000000001
1000000000000000000000000000000000000000000000000000000000000000000001000000000001000000000001000000000001000000000001000000000001
1000000000000000000000000000000000000000000000000000000000000000000001000000000001000000000001000000000001000000000001000000000001
1000000000000000000000000000000000000000000000000000000000000000000001000000000001000000000001000000000001000000000001000000000001
1000000000000000000000000000000000000000000000000000000000000000000001000000000001000000000001000000000001000000000001000000000001
1000000000000000000000000000000000000000000000000000000000000000000001000000000001000000000001000000000001000000000001000000000001
1000000000000000000000000000000000000000000000000000000000000000000001000000000001000000000001000000000001000000000001000000000001
1000000000000000000000000000000000000000000000000000000000000000000001000000000001000000000001000000000001000000000001000000000001
1000000000000000000000000000000000000000000000000000000000000000000001000000000001000000000001000000000001000000000001000000000001
1000000000000000000000000000000000000000000000000000000000000000000001000000000001000000000001000000000001000000000001000000000001
1000000000000000000000000000000000000000000000000000000000000000000001000000000001000000000001000000000001000000000001000000000001
1000000000000000000000000000000000000000000000000000000000000000000001000000000001000000000001000000000001000000000001000000000001
1000000000000000000000000000000000000000000000000000000000000000000001000000000001000000000001000000000001000000000001000000000001
1000000000000000000000000000000000000000000000000000000000000000000001000000000001000000000001000000000001000000000001000000000001
1000000000000000000000000000000000000000000000000000000000000000000001000000000001000000000001000000000001000000000001000000000001
1000000000000000000000000000000000000000000000000000000000000000000001000000000001000000000001000000000001000000000001000000000001
1000000000000000000000000000000000000000000000000000000000000000000001000000000001000000000001000000000001000000000001000000000001
1000000000000000000000000000000000000000000000000000000000000000000001000000000001000000000001000000000001000000000001000000000001
1000000000000000000000000000000000000000000000000000000000000000000001000000000001000000000001000000000001000000000001000000000001
1000000000000000000000000000000000000000000000000000000000000000000001000000000001000000000001000000000001000000000001000000000001
1111111111111111111111111111111111111111111111111111111111111111111111111111111111111111111111111111111111111111111111111111111111