NO ./png_files/castle.png
SO ./png_files/castle1.png
EA ./png_files/castle2.png
WE ./png_files/castle3.png

C 211,211,211
F 128,128,128

1111111111111111111111111
1000000000110000000000001
101100000111000000000000111111
10010000000000000000000000000011111111
111111000000000000000000000000000000001
10000000000000000000000000001111111111111
111101000000000000000000000000100011   11
11110100000000000000000000000010001    1111
110000000000000000000000000000100011111111111
10000000000000000000000000000000001
1000000000000000110101001000111111
11000001110101011111011110N0111
11110111 1110101 101111010001
11111111 1111111 111111111111